..........
..........
..x.......
.....x....
..........
....x.....
..g.......
...x...g..
..........
......g..g