....gg....
.xx.xx.xx.
.xx.xx.xx.
.xx.xx.xx.
..........
.xx.xx.xx.
.xx.xx.xx.
.xx.xx.xx.
.x......x.
....gg....