....gg....
.xx....xx.
.xx.xx.xx.
.xx.CC.xx.
Cxg....gx.
.xx.xx.xx.
.xx.xx.xx.
.xx.xx.xx.
.xx....xx.
....gg....