.....g....
.xx.xx.xx.
.xx.xx.xx.
.xx.xx.xx.
....C.....
.xx.xx.xx.
.xx.xx.xx.
.xx.xx.xx.
..x....x..
....g.....