....gg....
.xx....xx.
.xx.xx.xx.
.xx.xx.xx.
....xx....
....gg....
.xx....xx.
.xx....xx.
.xx....xx.
....gg....