....gg....
..........
....xx....
....xx....
g........g
....xx....
....xx....
....xx....
..........
....gg....