....gg....
..........
....xx....
....xx....
g...CC...g
....xx....
....xx....
....xx....
....C.....
....gg....