.....g....
..........
....xx....
....xx....
..........
....xx....
....xx....
....xx....
..........
....g.....