....gg....
.xx.xx.xx.
.xx.xx.xx.
.xx.xx.xx.
C........C
.xx....xx.
.xx....xx.
.xx....xx.
..........
....gg....