.....g....
..........
....xx....
....xx....
....C.....
....xx....
....xx....
....xx....
..........
....g.....